NO ./textures/wallN.png
SO ./textures/wallS.png
WE ./textures/wallW.png
IA ./textures/wallE.png
F 72,72,72
C 32,32,32

1111111111111111111111111111111111111111111111111111111111111111111111111111111111111111111111111111111111111111111111
11                                                                                                                  11
11                                                                                                                  11
11                                                                                                                  11
11                                                                                                                  11
11                                                                                                                  11
11                                                                                                                  11
11                                                                                                               11111
11                                                                                                                  11
11                                                                                                                  11
11                                                                                                                  11
11                                                                                                                  11
11                                                                                                                  11
11                                                                                                                  11
11                                                                                                                  11
11                                                                                                                  11
11                                                                                                                  11
11                                                                                                                  11
11                                                        N                                                          11
11                                                                                                                  11
11                                                                                                                  11
11                                                                                                                  11
11                                                                                                                  11
11                                                                                                                  11
11                                                                                                                  11
11                                                                                                                  11
11                                                                                                                  11
11                                                                                                                  11
11                                                                                                                  11
11                                                                                                                  11
11                                                                                                                  11
11                                                                                                                  11
11                                                                                                                  11
1111111111111111111111111111111111111111111111111111111111111111111111111111111111111111111111111111111111111111111111
