NO     ./images/Bricks.xpm
SO    ./images/gokux64.xpm
WE    ./images/nazi.xpm
EA    ./images/my_tanned_eggs.xpm
F 72,72,72
C 32,32,32

   111111111111111111
111001   111        11   
1N   1      1 11   1111   
111011       1        1
1111 11111 111111111111