NO ./textures/wallN.png
NO ./textures/wallS.png
WE ./textures/wallW.png
EA ./textures/wallE.png
F 72,72,72
C 32,32,32

1111111111111111111111111111111111111111111111111111111111111111111111111111111111111111111111111111111111111111111111
11                                                                                                                  11
11                                                                                                                  11
11                                                                                                                  11
11                                                                                                                  11
11                                                                                                                  11
11                                                                                                                  11
11                                                                                                               11111
11                                                                                                                  11
11                                                                                                                  11
11                                                                                                                  11
11                                                                                                                  11
11                                                                                                                  11
11                                                                                                                  11
11                                                                                                                  11
11                                                                                                                  11
11                                                       111111                                                           11
11                                                       100001                                                          11
11                                                       10N01                                                         11
11                                                        111111                                                         11
11                                                                                                                  11
11                                                                                                                  11
11                                                                                                                  11
11                                                                                                                  11
11                                                                                                                  11
11                                                                                                                  11
11                                                                                                                  11
11                                                                                                                  11
11                                                                                                                  11
11                                                                                                                  11
11                                                                                                                  11
11                                                                                                                  11
11                                                                                                                  11
1111111111111111111111111111111111111111111111111111111111111111111111111111111111111111111111111111111111111111111111
