NO ./textures/wallN.png
SO ./textures/wallS.png
WE ./textures/wallW.png
EA ./textures/wallE.png
F 1009,72,72
C 32,32,2005
111 111
1001001
10000001
100N001
1000001
1100011
1110001
1110011     111111
1110011111110001
111000000000001
111111111111111