NO ./textures/
SO ./textures/wallS.png
WE ./textures/wallW.png
EA ./textures/wallE.png

F 72,72,72
C 32,32,32

   111111111   
  11111110011
11111111100111111
1000000000E1    11
11111011111111     111
    10000001011      1
    10000100001     11
    11100111001    11
111111000011111   11
111111111111111111

