NO ./textures/wallN.png
SO ./textures/wallS.png
EA ./textures/wallE.png
WE ./textures/wallW.png
F 72,72,72
C 32,32,32

   111111111   
  11111110011
11111111111111111
1000000000E    11
11  11         111
12               1
111111111111101111
111111111000000001
     1000001000001
     1000001010001
     1000000000001
     1111111111111
