NO ./textures/pinktree.png
SO ./textures/candytree.png
WE ./textures/icecream.png
EA ./textures/star.png

F 210,180,140
C 173,216,255

11111111111111
10010000000001
100100E0000001
11011111001001
11000000001001
11001111111111
11000000000001
11111111111001
11000000000001
10001111111111
10100000000001
11111111111111

