NO ./textures/dots.png
SO ./textures/dots.png
WE ./textures/dots.png
EA ./textures/dots.png

F 0,0,0
C 0,0,0

11111111111111
10010000000001
10010000000001
1101111N000001
11000000000001
11001111111111
11000000000001
11111111111001
11000000000001
11001111111111
11000000000001
11111111111111