NO ./textures/bars.png
SO ./textures/bars.png
WE ./textures/bars.png
EA ./textures/bars.png

F 0,0,0
C 0,0,0

111111111111111111111111111111
100000000011110000000000000001
1E0000000011110000000000000001
111011111001111001111111111101
100010000001000001000000000101
101110111101011111011111110101
101000100001010000010000010101
101011101111010111110111010101
101000001000010100000100010001
101111101011110101111101111101
100000101010000101000001000001
100000101010000101000001000001
100000101010010101000001000001
100000101010000101000001000001
111110101011111101011111011111
100010001010100001010000010001
101011111010101111010111110101
101000000010100000010100000101
101111111110111111110101111101
100000000000100000000100000001
101111111110101111111111111101
100000000010100000000000000001
101111111010111111111111111101
100000001010000000000000000001
101111101011111111111111111101
100000001000000000000000000001
111111111111111111111111111111

