NO ./textures/wallN.png
SO ./textures/wallS.png
EA ./textures/wallE.png
WE ./textures/wallW.png

F  34,139,34
C  135,206,235

111 111
1001001
10000001
100N001
1000001
1100011
1110001
1110011     111111
1110011111110001
111000000000001
111111111111110
111111
10001
11111