NO ../xpms/wall.png
SO ../xpms/wall.png
EA ../xpms/wall.png
WE ../xpms/wall.png

F  255, 69,0
C  100,0,0

11111111
1000N111
11111111