NO ../xpms/wall.png
SO ../xpms/wall.png
EA ../xpms/wall.png
WE ../xpms/wall.png

F 1,200,0
C 4, 4, 5

11111111
1000N111
11111111