NO ../textures/wall.png
SO ../textures/wall.png
EA ../textures/wall.png
WE ../textures/wall.png

F  34,139,34
C  135,206,235

11111111
10000001
10101001
10101001
10001001
10000001
1000N001
10000001
10000001
10111101
10000001
10000001
11111111