NO ./textures/wallN.png
SO ./textures/wallS.png
WE ./textures/wallW.png
EA ./textures/wallE.png

F 72,72,72
C 32,32,32

   111111111   
  11111110011
11111111100111111
1000000000E1    11
11111011111111    111
    10000001011      1
    10000100001     11
    11100111001    11
111111000011111   11
1111110000111111111
111111000011111111
11111100100000011
11111100100000011
11110000000000011
11110000000000011
11111100000001111
11111110000001111
11111111111111111


