NO ./textures/pinktree.png
SO ./textures/candytree.png
WE ./textures/icecream.png
EA ./textures/star.png

F 120,60,30
C 255,182,193

11111111111111
10000000000001
10000000000001
1100011N000001
11000000000001
11000000000001
11000000000001
11000000000001
11111111111111